###T#######T
#T#0#R#####T
#T#0#R#####T
T####1#####T
TTTTTTTTTTTT
