###T###
#T#0#R#
#T###R#
#0###1#
#######
