T0T0T0T0T0T
##########T
##0##1##0##
###########
#######0###
##########T
T#########T
